111111111111111111111111111111111111111
1P00000001000N00000000000000000000000C1
10000000N1000000N0000000100N0000001N001
10000N000100000000N00000100000N00010001
100N0000010000000000N00010000000N010001
1N000000010000000000000N100000000010001
100000N00000000000000000C00000000C100E1
111111111111111111111111111111111111111