1111111111111
10000000000N1
1000011110C01
1P001100E0101
1111111111111