1111111111111111111111111111111111111111111111111111111111111111111111111111
10010000000N110010000000N110010000000N110010000000N10010000000N10010000000N1
1000000000C0000000000000N110010000000N110010000000N10010000000N10010000000N1
1P001100E010110010000000N110010000000N110010000000N10010000000N10010000000N1
1000011110C0110010000000N110010000000N110010000000N10010000000N10010000000N1
1000011110C0110010000000N110010000000N110010000000N10010000000N10010000000N1
1000011110C0110010000000N110010000000N110010000000N10010000000N10010000000N1
1000011110C0110010000000N110010000000N110010000000N10010000000N10010000000N1
1000011110C0110010000000N110010000000N110010000000N10010000000N10010000000N1
1000011110C0110010000000N110010000000N110010000000N10010000000N10010000000N1
1000011110C0110010000000N110010000000N110010000000N10010000000N10010000000N1
1000011110C0110010000000N110010000000N110010000000N10010000000N10010000000N1
1000011110C0110010000000N110010000000N110010000000N10010000000N10010000000N1
1000011110C0110010000000N110010000000N110010000000N10010000000N10010000000N1
1000011110C0110010000000N110010000000N110010000000N10010000000N10010000000N1
1000011110C0110010000000N110010000000N110010000000N10010000000N10010000000N1
1000011110C0110010000000N110010000000N110010000000N10010000000N10010000000N1
1000011110C0110010000000N110010000000N110010000000N10010000000N10010000000N1
1000011110C0110010000000N110010000000N110010000000N10010000000N10010000000N1
1000011110C0110010000000N110010000000N110010000000N10010000000N10010000000N1
1000011110C0110010000000N110010000000N110010000000N10010000000N10010000000N1
1000011110C0110010000000N110010000000N110010000000N10010000000N10010000000N1
1000011110C0110010000000N110010000000N110010000000N10010000000N10010000000N1
1000011110C0110010000000N110010000000N110010000000N10010000000N10010000000N1
1000011110C0110010000000N110010000000N110010000000N10010000000N10010000000N1
1000011110C0110010000000N110010000000N110010000000N10010000000N10010000000N1
1000011110C0110010000000N110010000000N110010000000N10010000000N10010000000N1
1000011110C0110010000000N110010000000N110010000000N10010000000N10010000000N1
1000011110C0110010000000N110010000000N110010000000N10010000000N10010000000N1
1000011110C0110010000000N110010000000N110010000000N10010000000N10010000000N1
1000011110C0110010000000N110010000000N110010000000N10010000000N10010000000N1
1000011110C0110010000000N110010000000N110010000000N10010000000N10010000000N1
1000011110C0110010000000N110010000000N110010000000N10010000000N10010000000N1
1111111111111111111111111111111111111111111111111111111111111111111111111111